أحمد أويحيى
7

مرسوم تنفيذي رقم 195-11 مؤرخ في 19 جمادى
الثانية عام 1432 الموافق 22 مايو سنة 2011
يعدل المرسوم التنفيذي رقم 356-98 المؤرخ في
4 رجب عام 1419 الموافق 14 نوفمبر سنة 1998
الذي يحدد كيفيات تطبيق أحكام القانون رقم

028 المؤرخ في 4 صفر عام 1419 الموافق 30
مايى سنة 1998 والمتعلق بالمحاكم الإدارية.

إن الوزير الأول.

- بناء على تقرير وزير العدل. حافظ الأختام.

- وبناء على الدستور,؛ لا سيِّما المادتان 85 -3
و125 ( الفقرة 2) منه.؛

- وبمقتضى القانون العضوي رقم 01-98 المؤرخ
في 4 صفر عام 1419 الموافق 30 مايو سنة 1998 والمتعلق
باختصاصات مجلس الدولة وتنظيمه وعمله.

- وبمقتضى القانون رقم 02-98 المؤرخ في 4 صفر
عام 1419 الموافق 30 مايو سنة 1998 والمتعلق بالمحاكم
الإدارية.

- وبمقتضى القانون رقم 09-08 المؤرخ في 18
صفر عام 1429 الموافق 25 فبراير سنة 2008 والمتضمن
قانون الإجراءات المدنية والإدارية.

- وبمقتضى المرسوم الرئاسي رقم 10 - 149
المؤرخ في 14 جمادى الثانية عام 1431 الموافق 28
مايو سنة 2010 والمتضمن تعيين أعضاء الحكومة.

- وبمقتضى المرسوم التنفيذي رقم 356-98 المؤرخ
في 24 رجب عام 1419 الموافق 14 نوفمبر سنة 1998
الذي يحدد كيفيات تطبيق أحكام القانون رقم 02-98
المؤرخ في 4 صفر عام 1419 الموافق 30 مايو سنة 1998
والمتعلق باللحاكم الإدارية.

- وبمقتضى المرسوم التنفيذي رقم 409-08 المؤرخ
في 26 ذي الحجة عام 1429 الموافق 24 ديسمبر سنة 2008
والمتضمن القانون الأساسي الخاص بمستخدمي أمانات
الضبط للجهات القضائية.

- وبعد موافقة رئيس الجمهورية.9 جمادى الثانية عام 1432ه
2 مايوسنة 2011م

يرسم ما ياتي :

المادة الأولى : يهدف هذا المرسوم إلى تعديل أحكام
المرسوم التنفيذي رقم 356-98 المؤرخ في 24 رجب عام
9 الموافق 14 نوفمبر سنة 1998 الذي يحدد كيفيات
تطبيق أحكام القانون رقم 02-98 المؤرخ في 4 صفر عام
9 الموافق 30 مايو سنة 1998 والمتعلق بالمحاكم
الإدارية.

المادة 2 : تعدل المواد 2 و5 و6 من المرسوم التنفيذي
رقم 356-98 المؤرخ في 24 رجب عام 1419 الموافق 14
نوفمبر سنة 1998 والمذكور أعلاه. وتحرر كما يأتى :

"المادة 2 : يرفع عدد المحاكم الإدارية إلى ثمانية
و أربعين (48) محكمة عبر كامل التراب الوطني.

يحدد اختصاصها الإقليمي طبقا للجدول الملحق
بهذا المرسوم".

"/لمادة 5 : يحدد رئيس المحكمة الإدارية. في إطار
ممارسة مهامه.؛ عدد الغرف. بموجب أمرء حسب أهمية
وحجم النشاط القضائي. في حدود غرفتين (2) على
الأقل.

الجريدة الرسميّة للجمهوريّة الجزائريّة / العدد 29

يمكن رئيس المحكمة الإدارية أن يقسم كل غرفة إلى
قسمين (2) على الأقل".

"/المادة 6 : تسند كتابة ضبط المحكمة الإدارية إلى
رئيس أمانة ضبط ويساعده كتاب ضبط؛ تحت سلطة
ورقابة محافظ الدولة ورئيس المحكمة الإدارية".

المادة 3 : تلغى أحكام المادة 3 من المرسوم التنفيذي
رقم 356-98 المؤرخ في 24 رجب عام 1419 الموافق 14
نوفمبر سنة 1998 الذي يحدد كيفيات تطبيق أحكام
القانون رقم 02-98 المؤرخ في 4 صفر عام 1419 الموافق
0 مايو سنة 1998 والمتعلق بالمحاكم الإدارية.

المادة 4: ينشر هذا المرسوم في الجريدة الرسميَة
للجمهوريّة الجزائريّة الديمقراطيّة الشّعبيّة.

حرر بالجزائر في 19 جمادى الثانية عام 1432
الموافق 22 مايو سنة 2011.

أحمد أويحيى

الملحق
الاختصاص الإقليمي للمحاكم الإدارية

المحاكم الإدارية البلديات

أدرار - بودة - أولاد أحمد تيمي - تسابيت - السبع - فنوغيل - تامنطيت - تاماست -
تيميمون - أولاد السعيد - أولاد عيسى - أوقروت - دلدول - شروين - المطارفة -
تينركوك - تالمين - قصر قدور - رقان - سالي - برج باجي مختار - تيمياوين - زاوية

كنتة - اين زغمير - أولف - تيمقتين - أقد ي - تيت.

الشلف - السنجاس - أم الذروع - الأبيض مجاجة - الحجاج - بوقادير - أولاد بن عبد
القادر - وادي سلي - صبحة - تنس - أبو الحسن - المرسى - بني حواء - سيدي عكاشة -
سوق البقر - تلعصة - مصدق - وادي قوسين - بريرة - أولاد فارس - الشطية - بوزغاية
- تاجنة - الزبوجة - بنايرية - عين مران - تاوقريت - الهرنفة - الظهرة.

عين الدفلى - روينة - العامرة - عريب - جليدة - بوراشد - زدين - المخاطرية - جمعة
أولاد الشيخ - بطحية - العطاف - أولاد عباس - بنى بوعتاب - حرشون - العبادية -
تبركانين - الماين - بالعاص - عين بويحي - تاشتة زقاغة - بني راشد - الكريمية - وادي
الفضة - مليانة - بن علال - حمام ريغة - عين البنيان - عين التركي - حسينية - خميس
مليانة - طارق ابن زياد - سيدي الأخضر - بر أولاد خليفة - برج الأمير خالد - جندل -
وادي الشرفاء - بربوش - وادي جمعة - عين لشياخ - عين السلطان - الحسنية - بومدقع.

2 2 9 9 جمادى الثانية 2ه
الجريدة الرسميَّة للجمهوريّة الجزائريّة / العدد 29 ال ا

الملمق (تابع)

المحاكم الإدارية البلديات
الأغواط الأغواط - قصر الحيران - المخرق - سيدي مخلوف - حاسي الدلاعة - حاسي الرمل - عين
ماضي - تاجموت - العسفية - الحويطة - الخنق - أفلو - قلتة سيدي سعد - عين سيدي

علي - بيضاء - بريدة - الغيشة - الحاج المشري - سبقاق - تاويالة - وادي مرة - سيدي

بوزيد - وادي مزي - تاجرونة.

غرداية - ضاية بن ضحوة - القرارة - العطف - بونورة - بريان - متليلى - زلفانة -
سبسب - حاسى الفحل - المنصورة - المنيعة - حاسى القارة.

أم البواقي - قصر الصباحي - عين الزيتون - عين بابوش - عين الديس - عين البيضاء -
وادي نيني - الدهالة - بريش - فكيرينة - الزرق - عين مليلة - بدّر الشهداء - أولاد
قاسم - أولاد حملة - أولاد الزوي - سوق نعمان - عين كرشة - عين الفكرون - الحرملية -
لعامرية - الفجوج بوغرارة سعودي - هنشير - تومغاني - سيقوس - مسكيانة -
لجازية - الراحية - بحير الشرقي - البلالة.

ُنشلة - تامزة - متوسة - الحامة - عين الطويلة - النسيغة - بغاى - قايس - الرميلة -
فايس - يابوس - بوحمامة - أمصارة - شلية - ششار - بابار - أولاد رشاش - المحمل -
لولجة - جلال - خيران

باتنة - تازولت - تيمقاد - شمرة - أولاد فاضل - فسديس - وادى الشعبة - عيون
لعصافير - بريكة - بيطام - مدوكل - أولاد عمار - إزيل عبدالقادر - الجزار - أريس -
شمول - ثنية العابد - بوزينة - منعة - تكوت - وادي الطاقة - تغرغار - غسيرة -
كيمل - أينوغيسن - فم الطوب - تيغائمين - شير - لرباع - مروانة- حيدوسة- وادي الماء
- أولاد سلام - تالغمت - قصر بلازمة - الحاسي- نقاوس - راس العيون - أولادسي
سليمان - تاكسلانت - بومقر - سفيان - القصبات - قيقبة - الرحبات - لمسان - عب
لتوتة - سقانة - أولاد عوف - معافة - بنى فضالة الحقانية - تيلاطو - سريانة - لازور-
زانة البيضاء - عين جاسر - عين ياقوت - جرمة - بومية - بوالحيلات - المعذر.

بجاية - تيشي- أوقاس - بوخليفة - تيزي نبربر - وادي غير - ثالة حمزة - خراطة -
سوق الاثنين -درقينة - تامريجت - تاسكريوت - آيت اسماعيل - ذراع القايد - ملبو -
سيدي عيش - تاوريرت اغيل - تيمزريت - بني كسيلة - أكفادو - لفلاي - شميني -
تينبذار - تيفرة - سيدي عياد - أذكار - السوق أوفلا - تيبان - أميزور- فرعون -
سمعون - كنديرة - توجة - بني جليل - برباشة - القصر - فلاين الماثن - آقبو -
تازمالت - بوجليل - اغيل علي - شلاطة - أوزلاقن - تامقرة - إيغرم - بني مليكش -
آيت رزين - صدوق - آمالو - بني معوش - بوحمزة - مسيسنة.

بسكرة- البرانس - القنطرة - عين زعطوط - الوطاية - جمورة - الحاجب - سيدي عقبة
- زريبة الوادي - شتمة - مشونش - الحوش - عين الناقة - الفيض - المزيرعة - خنقة
سيدي ناجي - أولاد جلال - الدوسن - الشعيبة - بسباس - رأس الميعاد - سيدي خالد -
طولقة - فوغالة - أورلال - مليلي - برج بن عزوز - مخلدمة - بوشقرون - أوماش -
الغروس - لواء - لشا

الوادي - وادي العلندة - البياضة - العقلة - الرباح - النخلة - حساني عبد الكريم - ميه
ونسى - المقرن - المغير - سطيل - سيدي خليل - أم الطيور - قمار - تاغزوت - ورماس
- الرقيبة - كوينين - الحمراية - جامعة - سيدي عمران - تندلة - مرارة - الدبيلة -
دوار الماء - بني قشة - حاسي خليفة - سيدي عون - طالب العربي - الطريفاوي.

9 جمادى الثانية عام 1432ه
2 مايوسنة 2011م

المحاكم الإدارية

بشار

الجريدة الرسميّة للجمهوريّة الجزائريّة / العدد 29

الملمق (تابع)

البلديات

بشار - قنادسة - بني ونيف - الأحمر - موغل - بوقايس - مريجة - بني عباس - إيقلي
- تامترت - الوطاء - بني يخلف - كر زاز - تيمودي - أولاد خضير - قصابي - العبادلة
- تاغيت - مشرع هواري بومدين - تبلبلة - عرق فراج.

تندوف - أم العسل.

البليدة - أولاد يعيش - الشريعة - بوعرفة - بني مراد - بوفاريك - الصومعة -
بوعينان - تسالة المرجة - أولاد شبل - الشبلي - بوقرة - السحاولة - بئرالتوتة -
بن خليل - أولاد سلامة - قرواو - حمام ملوان - العفرون - موزاية - وادي العلايق -
الشفة - وادي جر - بني تامو - عين الرمانة - الأربعاء - مفتاح - سيدي موسى - صوحان
- جبارة.

تيبازة - الناظور - سيدي راشد - عين تقورايت - مناصر - سيدي عمر - الشراقة -
لدرارية - أولاد فايت - سطاوالي - العاشور - عين البنيان - زر الدة - بابا حسن -
لقليعة - دواودة - فوكة - بواسماعيل - خميستي - المعالمة - بوهارون - الدويرة -
لشعيبة - الحطاطبة - الرحمانية - السويدانية - الخرايسية - حجوط - مراد - أحمر

لعين - بوركيكة - شرشال - قوراية - الداموس - لرهاط - أغبال - سيدي غيلاس -
مسلمون - سيدي سميان - بني ميلك - حجرة النص.

لبويرة - أهل القصر - بشلول - الشرفاء - الحيزر - مشد الله - الأسنام - حنيف -
بزيت - تاغزوت - العجيبة - أغبالو - عين الترك - الصهاريج - أولاد راشد - تاوريت -
لأخضرية - بودربالة - قرومة - قاديرية - معلة - أعمر - اليسري - جباحية - بوكروم -
سور الغزلان - ديرة - برج أخريص - مزدور - المرة - تاقديت - الدشمية - ريدان -
لمعمورة - الحجرة الزرقاء - عين بسام - بثّر غبالو - الهاشمية - سوق الخميس -
لخبوزية - عين العلوي - الماجن - وادي البردي - روراوة - عين الحجر.

تامنفست - أباليسا - ايدلس - تازروق - ان امقل - ان صالح - ان غار - فقارات
لزاوية - ان قزام - تين زواتين.

تبسة - بر الذهب - الحمامات - الكويف - الماء الأبيض - بكارية - الحويجبات - بولحاف
لدين - بر العاتر - أم علي - صفصاف الوسرة - نقرين - فركان - العقلة المالحة -
لشريعة - العقلة - بئر المقدم - قوريقر - ثليجان - بجن - المزرعة - سطع قنطيس -
لعوينات - مرسط - عين الزرقاء - الونزة - بوخضرة - المريج.

تلمسان - بني مسطر - تيرني بني هديل - عين فزة - شتوان - المنصورة - عين الغرابة
- الغزوات - السواحلية - دار يغمراسن - تيانت - مغنية - صبرة - حمام بوغرارة -
سيدي مجاهد - بني بوسعيد - بوحلو - سبدو - العريشة - القور - بني سنوس - سيدي
الجيلالي - لعزايل - بني بهدل - البويهي - الرمشي - عين يوسف - بني ورسوس -
هناية - الفحول - السبعة الشيوخ - أولاد رياح - زناتة - سوق الخميس - حنين -
تدرومة - فلاوسن - جبالة - عين الكبيرة - عين فتاح - باب العسة - السواني - مرسى
بن مهيدي - سوق الثلاثاء - مسيردة الفواقة - أولاد ميمون - وادي الشولي - بن سكران
- سيدي عبد اللي - عين تالوت - بني سميل - عمير - عين النحالة.

2 2 9 9 جمادى الثانية 2ه
الجريدة الرسميَّة للجمهوريّة الجزائريَّة / العدد 29 ال ا

المحاكم الإدارية

تيارت - تاقدمت - عين بوشقيف - دهموني - ملاكو - قرطوفة - السوقر - عين الذهب -
مدريسة - نعيمة - توسنينة - شحيمة - سي عبد الغني - الفايجة -فرئدة - مدروسة -
عين كرمس - تاخمرت - سيدي عبد الرحمن - عين الحديد - مادنة - سيدي بختي -
جبيلة الرصفاء - قصر الشلالة - زمالة الأمير عبد القادر - الرشايقة - سرغين - رحوية
- سيدي علي ملال - جيلالي بن عمار - وادي ليلي - تيدة - مشرع الصفاء.

تيسمسيلت - أولاد بسام - عماري - سيدي عابد - السبت -مغيلة - سيدي حسني -
المعاصم - خميستي - برج بونعامة - الأزهرية - بني شعيب - الأرجم - الملعب - سيدي
العنتري - بوقايد - بني لحسن - الأربعاء - تاملاحت - سيدي سليمان - ثنية الأحد - برج
الأمير عبد القادر - العيون - اليوسفية - سيدي بوتوشنت - مهدية - الحمادية - عين
زاريت - بوقرة - الناظورة - سبعين.

تيزي وزو - بني عيسي - بني زمنزر - آيت محمود - المعاتقة - بني دوالة - تيرمتين -
ذراع بن خدة - سوق الأثنين - سيدي نعمان - تادمايت - عزازقة - فريحة - سوامع -
آيت شفة - أيلولة أو مالو- إيعكورن - زكري - بوزقن - أزفون - ايفيفاء - اقرو - بني
زيكي - أجر - مقلع - أغريب - آيت خليلي - تيمزارت - ذراع الميزان - مشتراس -
تيزي غنيف - بونوح - فريقات - عين الزاوية - مكيرة - واضية - بوغني - تيزي نثلاثة
- وادي قصاري - اقني قغران - آيت بوعدو - اسي يوسف - عين الحمام - اقبيل -
أفرحونن - آيت يحي - أبي يوسف - اليلتين - أمسوحال - الأربعاء نايث ايراثن -
إيرجن - تيزي راشد - آيت اقواشة - آيت أومالو - واسيف - آيت بومهدي - ياطفان -
ابودرارن - آيت تودرت - بني يني - تيقزيرت - ماكودة - افليسن - بوجيمة - مزرانة
- واقنون - جبل عيسى ميمون.

بومرداس - زموري - تجلبين - الثنية - لقاطة - سي مصطفى - قورصو - برج مثايل -
الناصرية - جينات - يسر - تمزريت - شعبة العامر - الرويبة - عين طاية - برج
البحري - المرسى - هراوة - الرغاية - الأربعطاش - أولاد هداج - حمادي - خميس
الخشنة - بودواو - أولاد موسى - بوزقزة قدارة - عمال - بني عمران - سوق الأحد -
بودواو البحري - الخروبة - دلس - أفير - بغلية - سيدي داود - تورقة - أولاد عيسى -

سيدي أمحمد - الجزئر الوسطى - باب الوادي - بولوغين ابن زيري - القصبة - وادي
قريش - الحمامات الرومانية - رايس حميدو- بثّر مراد رايس - حيدرة - بر خادم -
المرادية - حسين داي - القبة -جسر قسنطيئنة - باش جراح - المغارية - بوروبة - الحراش
- المحمدية - وادي السمار - براقي - الكاليتوس - محمد بلوزداد - المدنية - الدار
البيضاء - باب الزوار - برج الكيفان - بوزريعة - بني مسوس - دالي ابراهيم - الأبيار
- ابن عكنون.

الجلفة - دار الشيوخ - المليليحة - حاسي بحبح - زعفران - حاسي العش - عين معبد -
سيدي بايزيد - بويرة الأحداب - عين وسارة - قرنيني - عين فكة - بن هار - حاسي
قدول - الخميس - بيرين - سيدي لعجال - حد الصحاري - مسعد - القطارة - أم العظام
- سلمانة - دلدول - سد الرحال - مجبر - عمورة - زكار - تاعظميت - فيض البطمة -
عين الإبل - الإدريسية - عين الشهداء - دويس - الشارف - القديد - بني يعقوب.

9 جمادى الثانية
2 مايوسنة 2011م

المحاكم الإدارية

2ه

الجريدة الرسميّة للجمهوريّة الجزائريّة / العدد 29

الملمق (تابع)

البلديات

جيجل - العوانة- تاكسانة - قاوس - سلمى بن زيادة - الطاهير - سيدي عبد العزيز -
الشقفة - الشحنة - جيملة - بوسيف أولاد عسكر - القنار نوشفي - بودريعة بن ياجيس
- برج الطهر - وجانة - الأمير عبد القادر - الميلية - السطارة - سيدي معروف - أولاد
يحي خدر وش - أولاد رابح - غبالة - العنصر - قمير وادي عجول - الجمعة بني حبيبي -
بوراوي بلهادف - زيامة منصورية - أراقن.

سطيف - عين عباسة - الوريسية - عين أرنات - مزلوق - أولاد صابر - عين الكبيرة -
عموشة - بني عزيز - بابور - أولاد عدوان - الدهامشة - عين السبت - سرج الغول -
معاوية - وادي البارد - تيزي نبشار - عين ولمان - قجال - قلال بوطالب - قصر الأبطال
- أولاد سيدي أحمد - بوقاعة - قنزات - تالة - تالة إيفاسن - حمام القرقور - عين الروى
- بني حسين - حربيل - ماوكلان - ذراع قبيلة - بوعنداس - العلمة - بني فودة - أم
العجول - بئر العرش - بازر الصخرة - القلتة الزرقاء - جميلة - الثلة - الطاية - الولجة
- بلعة - تاشودة - عين أزال - صالح باي - بيضاء برج - عين الحجر - بدّر حدادة - الحامة
- أولاد تبان - الرصفة - بوطالب - بني ور تيلان - عين لقراج- بني شبانة - بني موحلي
- بوسلام - آيت تيزي - آيت نوال مزادة. ‎١ ١ ١‏

برج بوعريريج - مجانة - حسناوة - الحمادية - الرابطة - العش - رأس الوادي - عين
تاغروت - برج الغدير - سيدي مبارك - أولاد ابراهيم - بئّر قصد علي - تكستر - خليل
- عين تسرة - تقلعيت - غيلاسة - العنصر - بليمور - المنصورة - المهير - ثنية النصر
- بن داود - أولاد سيدي ابراهيم - حرازة - الياشير - القصور - برج زمورة - تسمرت -
أولاد دحمان - الجعافرة - الماين - تفرق - القلة.

سعيدة - دوي ثابت - عين الحجر - أو لاد خالد - مولاي العربي - يوب - حنات - سيدي
عمرو - سيدي بوبكر - سيدي أحمد - الحساسنة - المعمورة - عين السخونة - أولاد
ابراهيم - تيرسين - عين السلطان.

البيض - روقاصة - بريزينة - غسول - كراكدة - الشقيق - الأبيض سيدي الشيخ - عين
العراك - عرباوة - المهارة - البنود - شلالة - بوسمغون - بوقطب - الخيثر - توسمولين

- الكاف الأحمر - بوعلام - سيدي طيفور - سيدي سليمان - سيدي عامر - ستيتن.

النعامة - عين بن خليل - عسلة - عين الصفراء - تيوت - سفيسيفة - مغرار- جنين

بورزق - مشرية - مكمن بن عمر - قصدير - البيوض.

سكيكدة - عين زويت - الحدائق - فلفيلة - بوشطاطة - حمادي كرومة - رمضان جمال -
القل - بني زيد - أولاد عطية - وادي الزهور - الزيتونة - الشرائع - قنواع - خنق
مايون - الكركرة - عزابة - جندل سعدي محمد - عين شرشار - بكوش الأخضر - بن
عزوز - السبت - المرسى - الغدير - الحروش - زردازة - أولاد حبابة - سيدي مزغيش -
مجاز الدشيش - بني ولبان - عين بوزيان - بني بشير - صالح بوالشعور - تمالوس -
عين قشرة - أم الطوب - بين الويدان - الولجة بو البلوط.

2 2 9 9 جمادى الثانية 2ه
الجريدة الرسميَّة للجمهوريّة الجزائريّة / العدد 29 ال ا

الملمق (تابع)

المحاكم الإدارية البلديات
سيدي بلعباس سيدي بلعباس - تسالة - سيدي ابراهيم - أمرناس - سيدي لحسن - سيدي خالد -
الثريد - سيدي يعقوب - عين قادة - سحالة شاورة - تلاغ - مرحوم - تافسور - مولاي
سليسن - الحسيبة - رأس الماء - سيدي شعيب - وادي تاوريرة - عين تندمين - الضاية -
واذي السيع - تغاليمت - بتر الحمام - تاودموت - رجم دموش - مرين - مزاورو -
- مصطفى بن إبراهيم - مقدرة - تلموني - تثيرة - مسيد - عين البرد - عين
عدار زروالة - بوجبع البرج - بلعربي - سيدي حمادوش - وادي سفيون - بن عشيبة
شلية - ابن باديس - بوخنيفيس - سيدي علي بوسيدي - حاسي زهانة - طابية - بدر
الدين المقراني - لمطار - سيدي دحو الزاير - سيدي علي بن يوب - شتوان بليلة - حاسي
دحو.

عين تموشنت - أغلال - عين الكيحل - عين الطلبة - سيدي بن عدة - عقب الليل -
شنتوف - بنى صاف - ولهاصة الغرابة - سيدي صافى - تادماية - الأمير عبد القادر -
العامرية - بوزجار - حاسي الغلة - المساعيد - حمام بوحجر - عين الأربعاء - وادي
الصباح - سيدي بومدين - الحساسنة - وادي برقش - تامزورة - المالح - تارقة - شعبة
اللحم - أولاد كيحل - أولاد بوجمعة.

عنابة - سرايدي - برحال - وادي العنب - شطايبي - التريعات - الحجار - البوني -
سيدى عامر - الشرفاء - العين الباردة - العلمة.

الطارف - بوقوس - بوثلجة - بحيرة الطيور - الزيتونة - القالة - العيون - السوارخ -
عين العسل - بريحان - رمل السوق - الذرعان - شهاني - شبايطة مختار - بن مهيدي -
عصفور - زريزر - البسباس - الشط - بوحجار - عين الكرمة - وادي الزيتون - حمام
بني صالح - الشافية.

قالمة - هيليوبوليس - الفجوج - بوعاطي محمود - عين العربي - مجاز عمار - حمام
دباغ - قلعة بوسبع - بن جراح - بني مزلين - بلخير - عين الحساينية - بومهرة أحمد -
وادي الزناتي - عين مخلوف - بوحمدان - الركنية - سلاوة عنونة - تاملوكة - رأس
العقبة - برج صباط - عين رقادة - بوشقوف - بوحشانة - حمام النبايل - خزارة -
نشماية - وادي الشحم - وادي فراغا - عين صندل - الدهوارة - عين بن بيضاء - مجاز

الصفاء - جبالة الخميسى.

سوق أهراس - الحنانشة - لخضارة - المشروحة - أولاد مؤمن - أولاد ادريس - الحدادة -
عين الزانة - سدراتة - أم العظايم - بر بوحوش - مداوروش - سافل الويدان - الرقوبة
- خميسة - وادي الكبريت - ترقالت - الزوابي - عين سلطان - تاورة - الزعرورية-
الدريعة - المراهنة - ويلان - سيدي فرج - تيفاش.

قسنطينة - زيغود يوسف - ديدوش مراد - بنى حميدان - الخروب - عين عبيد - أولاد
رحمون - عين سمارة - الهرية - حامة بوزيان - بوجريو مسعود - ابن زياد.

ميلة - سيدي مروان - عين التين - سيدي خليفة - وادي النجاء - قرارم قوقة - الزغاية -
حمالة - الشيقارة - عميرة أراس - أحمد راشدي - ترعي باينان - تسالة لمطاعي -
فرجيوة - بوحاتم - تسادان حدادة - دراجي بوصلاح - ميثار زرزة - العياضي برباس -
يحي بني قشة - عين البيضاء حريش - الرواشد - تيبرقنت - شلغوم العيد - المشيرة -
وادي العثمانية - تلاغمة - عين ملوك - وادي سقان - بن يحي عبد الرحمن - تاجنانت -
أو لاد خلوف. ‎١‏

9 جمادى الثانية عام 1432ه
2 مايوسنة 2011م

المحاكم الإدارية

المدية

الجريدة الرسميّة للجمهوريّة الجزائريّة / العدد 29

المدية - وزرة - سي المحجوب - عوامري - بوعيشون - الحمدانية - أولاد بوعشرة - وادي
حربيل - تامزقيدة - دميات - ذراع السمار - حنائنشة - بن شكاو - البرواقية - الزبيرية
- أولاد دايد - الربعية - تابلاط - العزيزية - عيساوية - مزغنة - مغراوة - الحوضان -
القلب الكبير - ميهوب - سدراية - بني سليمان -سواقي - جواب - سيدي الربيع -
بوسكن - سيدي زهار - سيدي زيان - بئّر بن عابد - قصر البخاري - الشهبونية - أولاد
عنتر - مجبر - أولاد هلال - عزيز - مفتاحة - أم الجليل - السانق - بوغزول - دراق -
بوعيش - بوغار - عين بوسيف - أولاد معرف - ثلاثة دوائر - شلالة العذاورة - الكاف
الأخضر - سيدي دامد - تافروت - شنيقل - عين القصير - سغوان - العوينات - العمرية
- أولاد ابراهيم - سيدي نعمان - خمس جوامع - بوشراحيل - بعطة.

مستغائم - مزغران - حاسي معمش - ستيدية - فرناقة - عين نويسي - الحسيان -
بوقيراط - سيرات - السوافلية - صقفصاف - سيدي علي - حجاج - عبد المالك رمضان -
سيدي الأخضر - تزقايت - أولاد مع الله - عين تادلس - صور - وادي الخير - سيدي
بلعطار - خير الدين - عين بوديثار - صيادة - ماسرة - عين سيدي الشريف - الطواهرية
- منصورة - عشعاشة - نكمارية - خضراء - أولاد بوغالم.

غليزان - يلل- سيدي سعادة - سيدي خطاب - بلعسل - بوزقزة - المطمر - بن داود - عين
لرحمة - وادي الجمعة - سيدي محمد بن عودة - القلعة - وادي رهيو - مرجة سيدي عابد
- جديوة - الحمري - الحمادنة - أولاد سيدي ميهوب - الاحلاف - ورزان - عمي موسى -
لولجة - عين طارق - حد الشكالة - الرمكة - سوق الأحد - أولاد يعيش - الحاسي -
مازونة - سيدي محمد بن علي - القطار - مديونة - بني زنتيس - زمورة - بني درقون
- دار بن عبد الله - منداس - سيدي لزرق - وادي السلام.

لمسيلة - المعاضيد - أولاد دراج - المطارفة - شلال - أولاد ماضي - الصوامع - بوسعادة -
أولاد سيدي ابراهيم - سيدي عامر - تامسة - بن سرور - أولاد سليمان - الحوامد -
لزر زور - وادي الشعير - ولتام - بن زوح - مسيف - خبانة - المعاريف © سيدي عيي
- عين الحجل - سيدي هجرس - بوطى السايح - بني يلمان - خطوطي سد الجير -

لملح - يئر الفضة - الهامل - عين فارس - سيدي امحمد - أولاد عطية - مجدل لي
عين الريش - جبل مسعد - مقرة - برهوم - عين خضراء - بلعايبة - دهاهنة - أولاد عدي
لقبالة - حمام الضلعة - تار مونت - أولاد منصور - ونوغة.

معسكر - عين فارس - تيزي - القرط -المأمونية - تغنيف - سيدي عبد الجبار - سيدي
قادة - نسموط - السحايلية - وادي الأبطال - البرج - عين فراح - المثنور - الهاشم -
خلوية - محاميد - غريس - ماقضة - عين فكان - بنيان - قرجوم - عين فرس - مطمور
- سيدي بوسعيد - ماوسة - وادي تاغية - عوف - غروس - فروحة - المحمدية - سيدي
عبدالمؤمن -فراق قيق - الغمري - سجرارة - بوهني -مقطعالدوز - سيق - رأس عين
عميروش - الشرفاء - زهانة - القعدة - عكاز - العلايمية - بوحنيفية - حسين - قطنة.

ورقلة - عين البيضاء - الرويسات - سيدي خويلد - حاسي بن عبد الله - نقوسة -
توقرت - الطيبات - النزلة - تيبسبست - تماسين - المقارين - زاوية العابدية - سيدي
سليمان - بليدة عامر - الحجيرة - العالية - بن ناصر - المنقر - حاسى مسعود - البرمة.

إيليزي - جانت - برج الحواس - ان أميناس - الدبداب - برج عمر ادريس.

وهران - أرزيو - بطيوة - مرسى الحجاج - عين البية - السانية - سيدي الشحمي -
الكرمة - مسرغين - بوتليليس - المرسى الكبير - عين الترك - العنصر - بوصفر - عين
الكرمة - وادي تليلات - طفراوي - بوفتيس - البراية - بن فريحة - قديل - حاسي
مفسوخ - سيدي بن يبقى - بر الجير - حاسي بونيف - حاسي بن عقبة.

الجريدة الرسميّة للجمهوريّة الجزائرية / العدد 29

